####################
#                  #
#          ##      #
#                  #
#    ##            #
#                  #
#         ##       #
#                  #
#             ##   #
#                  #
#        ##        #
#    ##            #
#                  #
###                #
#    ##            #
#       ##         #
#           ##     #
#              ##  #
#           ##     #
####################