##############################
#                            #
#                            #
#                            #
#           #####            #
#                            #
#                            #
#     ####                   #
#                            #
#                            #
#                            #
#                            #
#                            #
#               ########     #
#                            #
#                            #
#                            #
#                            #
#                            #
#      ####                  #
#                            #
#                            #
#                            #
#                ####  #     #
#                            #
#                            #
#       ## #                 #
#                            #
#                            #
##############################