##############   #############
#                            #
#                            #
#                            #
#           #####            #
#                            #
#                            #
#     ####                   #
#                            #
#                            #
#                            #
#                            #
#                            #
#               ########     #
#                            #
#                            #
#           ###              #
#                            #
#                            #
#      ######                #
#                            #
#                            #
#                            #
#               #####  #     #
#                            #
#                            #
#       ## #                 #
#                            #
#                            #
##############################